@@@@@@@@@@@@@@@@@@@@
@@@@@@@@@@@@@@@@@@@@
@@@@@@@@@@ o@     @@
@@@@@@@@@oo   o o @@
@@   @@@@@@o@@ @ @@@
@@ o @@   @ @@ o  @@
@@ o  voo @ @@ooo @@
@@@ @@@   @ @@    @@
@@@ @   @@@ @@@@@o@@
@@@ @     o  @xxxx@@
@@  @@@ @@ o @xxxx@@
@@ o   o @   @xxox @
@@  @@ o @  @@xxxx @
@@@@@@   @@@@@@xxx@@
@@@@@@@@@@@@@@@@@@@@
@@@@@@@@@@@@@@@@@@@@
                    
                    
                    
                    
