@@@@@@@@@@ @@@@@@@@@
@@@@   v@@@     @@@@
@@@@@@ o   @ @@  @@@
@@   @@      @@@ @@@
@@ o @  @@    @ @@@@
@@ o @  @@@ @  @@@@@
@@@ o  o       @@@@@
@@@ o o @@@ @ @@@@@@
@@@ @  o  @ @ @@@@@@
@@@ @ @o@   @ @@@@@@
@@@ @@@   @ @ @@@@@@
@@  o  @@@@ @ @xxxx@
@@    o    o   xx@x@
@@@@@o  o@ o   xxxx@
@@       @  @@ xxxx@
@@@@@@@@@@@@@@@@@@@@
                    
                    
                    
                    
